00000000000000000000000000000
00000000000111000000000000000
00000000000114000000000000000
00000000000313000000000000000
00000002111111111200000000000
00000002222222111200000000000
00000001111511111200000000000
00000001111111111100000000000
00000001115151111100000000000
00000001112222222200000000000
00000001111111111200000000000
00000002222111122200000000000
00000003333333333300000000000
00000000000000000000000000000
00000000000000000000000000000
00000000000000000200000000000
00000000000000001200000000000
00000000000000000010000000000
00000000000000000000000000000
<!!!>
11<!>11
<!!!>
null
<!!!>