00000000000000000000000000000
00000000000000000000000000000
00000000000000000000000000000
00000000000000000000000000000
00000000000000000000000000000
00000000000000000000000000000
00000000000000000000000000000
00000000001111111000000000000
00000000001711331000000000000
00000000001111001000000000000
00000000001111111000000000000
00000000001111711000000000000
00000000003333333000000000000
00000000000000000000000000000
00000000000000000000000000000
00000000000000000000000000000
00000000000000000000000000000
00000000000000000000000000000
00000000000000000000000000000
<!!!>
11<!>11
<!!!>
Last level ((
<!!!>