0000000000000000000000000000000000000000000000000000000000
0000000000000000000000000000000000000000000000000000000000
0002211110000000000000000000000000000000000000000111100000
0002111261111111111111611111611111111111161111112141100000
0001111211161111116111111111111161116111111111612111200000
0001111333333333333333333333333333333333333333311112200000
0003333000000000000000000000000000000000000000033333300000
0000000000000000000000000000000000000000000000000000000000
0000000000000000000000000000000000000000000000000000000000
0000000000000000000000000000000000000000000000000000000000

<!!!>
4<!>5
<!!!>
null
<!!!>