00000000000000000000000000000
00000000000011111111520000000
00000000000011121211120000000
00000000000011125211120000000
00000000000031333333130000000
00000000002211122000100000000
00000000002331332000100000000
00000000001001001000100000000
00000000001111111000100000000
00000000001111111000100000000
00000000001331331001110000000
00000000002001002003130000000
00000000002211122000100000000
00000000003333333000100000000
00000000000000000000100000000
00000111011111252122120000000
00000141112121212111110000000
00000111312521111111110000000
00000333033333333333330000000
00000000000000000000000000000
<!!!>
11<!>8
<!!!>
null
<!!!>