00000000000000000000000000000
00000000000000000000000000000
00000000000000000000011100000
00000000001111111111114100000
00000000001111133323211100000
00000000003333100030333300000
00000000002611111200000000000
00000000001111111100000000000
00000000001111331100000000000
00000000001111001100000000000
00000000001111111100000000000
00000000001111111500000000000
00000000003333333200000000000
00000000000000000300000000000
00000000000000000000000000000
00000000000000000000000000000
00000000000000000000000000000
00000000000000000000000000000
00000000000000000000000000000
<!!!>
11<!>11
<!!!>
null
<!!!>