00000000000000000000000000000
00000000000000000000000000000
00000000000000000000000000000
00000000000000000000000000000
00000000000000000000000000000
00000000001111110000000000000
00000000001111110000000000000
00000000001111110000000000000
00000000001111110000000000000
00000000001111110000000000000
00000000001111110000000000000
00000000001111110000000000000
00000000003333330000000000000
00000000000000000000000000000
00000000000000000000000000000
00000000000000000000000000000
00000000000000000000000000000
00000000000000000000000000000
00000000000000000000000000000
<!!!>
13<!>9
<!!!>
null
<!!!>