00000000000000000000000000000
00000000000000000000000000000
00000000000011100000000000000
00000000000041100000000000000
00000000000011122222222000000
00000000000032111111111000000
00000000000002333333331000000
00000000001112111222221000000
00000000001112331001111000000
00000000001112001221221000000
00000000001111111111001000000
00000000001111111222223000000
00000000003333333333330000000
00000000000000000000000000000
00000000000000000000000000000
00000000000000000000000000000
00000000000000000000000000000
00000000000000000000000000000
00000000000000000000000000000
<!!!>
11<!>11
<!!!>
null
<!!!>