00000000000000000000000000000
00000000111000000000000000000
00000000111000011111111111000
00000000313000012212213333000
00000000010000013313310000000
00111111111000010010010000000
00111111111111112212210000000
00111111111333111111111111000
00333333333000333133333331000
00022222111222222122222201000
00111111111111111111111111000
00333311333113331123333333000
00000011000110001120000000000
00000011111111111120000000000
00000011111111111130000000000
00000033332113333300000000000
00000000002112000000000000000
00000000003333000000000000000
00000000000000000000000000000
<!!!>
3<!>6
<!!!>