00000000000000000000000000000
00000000000000000000000000000
00000000000011100000000000000
00000000000014100020000000000
00000000000111100030000000000
00000000000122200000000000000
00000000000115300000000000000
00000000000331000000000000000
00000002000001000000000000000
00000003000001100000000000000
00000000000001302000000000000
00000000000001003000000000000
00000000000111000000000000000
00000000000122200000000000000
00000000000111100000000000000
00000002000311100000000000000
00000003000011100000000000000
00000000000033300000000000000
00000000000000000000000000000
<!!!>
13<!>15
<!!!>
null
<!!!>